0011000100000111000110000000000000000100001010000001010100000000111111000000011000000000110000010000
1001010001110000011000110110101111110001100010111100010101111010000000111111000011101110100101010110
0101111111000101111011110010111000011111110110100101010000010010111110001101011110001000101101010100
0100001000010111000000001010010011000100100010110101001111100111101011100101010100111010100101011101
0111101011110100011101111011110111110110001010000100101000001000001000110001110001110011111101000000
0000101000011101110101000011000100010111111010110110100011011111100010111100000111100100010001111011
1011101110110001000111011010011111010010000110100010011110010000111010010111111000101101100110001001
1011001000100111010001010010110100011000110011001111010100100110001011010000001011101000001110100100
0001011101101100011101011010110001011111111001010001010001101111101111000101110000001011011100110111
1101001100101101110101001010110111011010001101010101010110000010100000111101010111111010000001010000
0001100110000101000101101110010101000010101101000101010011111010111110000101010000100011111011011110
0100010011110101011100100011000101111000101101110110011000001010000001110100011110011100001000000100
0111111001000101000010101001110101001111101000000010111011101001111101100101000011001101100111111001
0000000100111001101110101100010101100010001111111010011011101100001001001101101011101000110000001010
0110110110011010001000101111001101101000111000110011001100011111100011011111001000101110111111100010
1110100001010010101011100101101000101111100010010111101001000000111001000010011101100010001000011000
0000111111010110100010110101101010001000101111010001101011110110010101111011110101111010100111011110
0111000110010110111010010001000011111010101000001100100010110011010101001000010101000010110010000010
0100010100110110101010111101111110000010100111101111101110011011000100011111000100011111101010101110
0001110001100010100110000100010000111110110000100001000111011010110111000101110101110000101010101100
1011011111001110110000111111011110000011111110011101110010010010110101010000100101000110100010100001
1011000000011100100101110000000011010110000001011000111000110110100101011111101100011110001110111111
0001011011111001111100000111111001110000111101001010011110110010001101010000001111110001110000100001
1101011010010010000011101110001100001111100001101011000010001001100001010111101000000101000111110100
0001001011010111101000101100101111100011001100101001011001101100101110010101101011110101101100010111
1011101011010100001110011001101000011000010110101111000100100010101000110100110000010101100011000000
0011001001010001111011010011101101111111110110100001110110111010011011110110000111010100111001111110
0100011101011111011011000111001000000000010100111100011110100011001001000011111111110110000100100010
0111110001000000000001111000011111111011110101100011000010101001101100111001100000010111111110101000
0000100111101111111101000011111000000010000000101011110110111101101110001100001111010100000010101101
1110001000101110001101101110100011111100111111101011000100000100100000100111111101010001101010011101
0111111010101100100001101000101010001001100001001000011111110011101111110010000101001101001011000001
0100000010101001111110001011101000100010001110011011100010001000101000101011010101100101011000111100
0001101110110011010000111000101111101111101000111110001011101110111010101011010001110101001111110110
1010100110010110010111100010001000100010001101111000111001100000000010100011010100010011100011000110
1010110011000011010100001111110010111010101101110010000100011111111110101110011111111010001010010110
0010111001111011010011011000100110011000111000100111011111000100011000100000110000100011011000110010
0110000100001001011010001110101111001111000010101110000011110111001011101111100110110101000111101000
0110110111101100011010100110101000100001011110101000111000110011100010000010001010000101110001101111
0110100011001110110010110100101110101100010000101101111110011010001111111010111011111100011100001000
0000101010010010100111000101100110101111110101101001000011001010111000100010101000100101010111100011
1011111110110110101001011100110010001100010101101011011011011010001010011100100010110001010001111001
0011000010010000101011000110111001111001001101101110011001110011011011010001101110111011010100001100
0100011011001110101011110000110101010011101100100100101100000101001001011011001000010010010111101110
0101101011101000101000011110010101010110100111110101101111111101101101011010011111000111100101100110
0101101001001011101111000111000101010000110000000101100010001000100001001011000011111110001100010010
1001101100011000100010110000110100011110111111111101101000101010111111100010011000100000110001011000
1011000111111101111010100110100111000010100010010000101111100010100000111110100010101111110111010111
0010010100001001001010001000101001011100001000110111101000011010001111000010111110100000000110010110
0110111101011011011010111011101011011101111110010000101111011111100000011010110000111111111000110000
0010000101011011011010011110000010011001100011011110100110000000111110111010100110010000001011100110
1010110101010001010011000000110110110011001011111000110010111101100100100011101111110110111010001100
0010010101011101010111111111110010010111011011000011101010110101001101101000001000110110010011010101
0111010101010000010011100010001011000110010000011110101000100100011100101111111010000101000101010101
0100010101010111011000001010101000111100111111100010001111101111000010110000100010111101111101010100
0111010001000001111111101000101110000101100001001000100000001101011010010110001111110000000101010110
0011011101011110000000111111100010111001001100011110111111100100011011010001111000001111110101000100
1010001111110000110111000001111010100011010111100011110000010001001011001100001011100001110001110101
1011101000000110010101011100000010110110010100001000000111011111111000101111101010111100000100010100
1000111011111111110001000111111110100010110001101101110101110000001111101000100010000011111111001110
1010100011000000111101101101100010111010011011111101000101000111101000101110101110101110000001100010
0010101110011110100001000101001010001011001110000101111100011000001010100000111010100001111100011000
0110000100111110110101110100011010101011100011010001100001111111011010111010000011110101011001000110
0111111101111110000101000101111010101000111010010100101111100010000010001011111000110101000011110100
0010001100000001101101011100001011101010001000110110100010001011111110101010001010000100011100000101
1001100111111101101110000111111000001111101111000111101000111000010011100010101110111111111101111101
1101110000000100011000111000000111100000100011111000101111000111011000001100100011110000100000000101
0001000110110111011010110011110100011110101000001010100101110101001011111001111010001110001111110101
1011101110100001001010100100010101000010101110111010110100010101101011101011011000100011011100010101
1010101110101111101011001101000101110110011000100010110001010101101011001001000111111001000101011101
1010101110101000001000010101111101000111010011001010001111010001101000011101010100001101111101000100
0000101110101101111111110100100101011000010111011111100101011011001111111001010110100100000101010110
1110110000110001000000000010110101111011110011010000110100000010010000000011110100110111110001010010
0010010111100111011111111010100100010011011000011010100011111010111101111111000101000100111110111010
1011010110001100001000001010101101000100011111111010111010001010111001100000010111010110001110100010
1001010100110001111010111010101101010101000000001010001000100110010011001101110000010100100000101100
0011010101110111001010110010100011011101011101100010111111110101000100011000011111110001111110100001
0110000101110000011010000110001011000011000101111010010001000101010111111011000110001110000110111111
0100110101100111110001111111111001111011110100011011110100010101010100001011110010100110110011000000
0101111100101100011101010000000100001000010111001100000101010101011001101000011000110000001000011011
0001000110001101001101000111010111101111010001100101111101111100000010000111010111111111101111111000
0110010011111001100100011110010100001001001101010100001110000011111111110001010100000110100000001101
0100111001100011110011111000110110111101101101010111100110111000000000011101000110111000101111111000
0101100100001010001000000011000110100100001000010000010100111111111111010001110110110010111010110010
0100110111111011101111111010011010110011011010111101010001011000100011010111100100010110100010000110
0110010110000001101000011110111010011000011110001001011111010010001100010010001001010010101011101110
0111010000111100100011000010011011001101110001101011000010000110101101111011011011111010001001100110
0010011111110110101011111001000001100100000100101001111011101100101000100010000010001010111100110010
1010111000000111101000101101111101110011111110011101000000101001101110101110111110100010100010111001
0010001010111100001111000101000100001001101011000001011110001011101000100010001000111111001010011101
0111100010010001110000010100010111101100001001101111111011111011101011111011101011000100011111010000
0000111111000110000110110111010000101111101101001000001000011011001010001000101010010111000001011010
1110100000111111101110001101010101101110100101011011100111001110010010101110011010110010011011011011
0000101010100000000011101000110101100000110100010010110011100000110110101011001000011010111010010000
0111101010011111111000101010010100011110100011100110001001101111010001101000100111110010110010111110
0000101011001100000101101111001111011010111001001000101100100001010101101011110100000111000110100000
1110111011100101110101000011100001001000000100011011101110011100011101101001100111011110010100110111
0110100011110101000111011000111100100111110111111010001111001111100000101100001110011000111101100000
0010001100000011010000011110001110110100011110000011110001101000101111101001101100100010001000111110
1000110001111000010111100000100000010001000000111000000100000010001000000010000001101010100010000002
