010011100001000000010000010100
011000001100111011011011010001
001011111110001011011010010101
101000100100101001010010110100
001110101101101101000110010111
010000100000101101110001010001
010111111111100100011111011100
000110000000010111000001000110
111000111111110000111101110010
001010101000001110100001011010
101010001010111100111011001010
001011110010100001110011011000
011011000110001111000100011101
001010011111111100011111010001
101010100000001001001000010110
000010111011101111101110110110
010110001000100000101000100110
110001100110111110001101101100
000101110010010011110000000001
011101111011000110110111111100
000110001000110010000100001110
010110101110101001111001101000
010100100010101100100011101011
010001001110101110001001001010
011111010000101111111101011000
010100011101100001000101001110
000101001001101100010011100010
101101111010000011111000101010
000100100010111110001110111010
010110001000100000100000000020
