01000101110000100001000011000000010000000000000100
00010100000110001100111010011011000111111111110110
11110111011110101110101010111001111100001100000110
00110001000100111000001000000101000001110001111100
10011100110111000111100111110101010110000110001101
11000110110100010110110100011101010000111110100000
10010110100101110010000001001001100111000010101110
00110100101100001001111111101010101111011001111000
01000001101111101101000000100010100000011100100010
01111110000000100100111101101110111111100010001110
00000011111110110110010000111010100011101011110010
11111010000010110111001110000010001000001000110110
00101000101100100000100010101110111111011110010100
10001111100101101110111010100010101101001011010001
11100000110100000011100010110110100001101000010111
00001011000101111100001110100010001101001011110000
01011010011100111001111010111011111101011000011101
01010010100010010010001010001000001001000111100000
11010110101011010111100011011111100011010000001111
00010110101001110100001100010000011111111111110000
01110110101100010101011001111111010100001000010110
01000110001011000101011011010000010001101011100010
01110001111011111110010001000111000110001001101010
00011111001000001110110111010101111110111101001010
01000000011010100000100110010100000010000100011010
01111110110010110111101000100111101111110110100001
01000010010110010101001011101000100110010110111101
01110111010011001100011011001010110000110010100001
00100011011000101101111110010010010110011010101101
10111010001110101001000000110111000111110010101100
00100010101000101011010111100101110100000110100111
01110110101011100010010000110100010110111010110000
01110100110010111110111110110101100100101010001101
01110101110110000010001000110100001101100000111101
00100100010010111100110011100101111100111110010000
10001110111010110101110110001101100010010010110110
00101010101010010101110010101101001011011010100100
01101000001011000101101010100101011001001000101101
11101011101001010100101010110111001100101101000101
00011001001101010010001010110001100010101001011101
01001101100100111011011010001101011010001011010001
01101100111110001000011011101001010011111110010110
00100110000001100111100010001011000110100000110110
10010001101101110011101110101010011000001101110110
11010100001000011001000011111010101111111101000100
00010101111111011101011000100010101100001101011101
10111100010001110001000110101100001001100101000001
00000011110100100111111100100001110011110001111101
01111001100110101110001001101111000100011110000000
00000100001000000000100010000000010101000000111112
